2,1,1,1,1,1,1,6,6,6,6,6,6,6,6,6,6,6,6,6,6,6,6,6,6,6,1,1,1,6,6,6,6,6,6,6,6,6,6,6,6,6,6,6,6,6,6,6,1,1,1,6,6,6,6,6,6,6,6,6,6,6,6,6,6,6,6,6,6,6,1,1,1,6,6,6,6,6,6,6,6,6,6,6,6,6,6,6,6,6,6,6,6,6,6,6,6,6,6,2
2,0,0,0,1,1,1,0,0,0,0,0,0,0,0,0,0,0,0,0,0,0,0,0,0,0,1,1,1,0,0,0,0,0,0,0,0,0,0,0,0,0,0,0,0,0,0,0,1,1,1,0,0,0,0,0,0,0,0,0,0,0,0,0,0,0,0,0,0,0,1,1,1,0,0,0,0,0,0,0,0,0,0,0,0,0,0,0,0,0,0,9,9,0,0,0,0,0,0,2
2,0,0,0,1,1,1,0,0,0,0,0,0,0,0,0,0,0,0,0,0,0,0,0,0,0,1,1,1,0,0,0,0,0,0,0,0,0,0,0,0,0,0,0,0,0,0,0,1,1,1,0,0,0,0,0,0,0,0,0,0,0,0,0,0,0,0,0,0,0,1,1,1,0,0,0,0,0,0,0,0,0,0,0,0,0,0,0,0,0,0,9,9,0,0,0,0,0,0,2
2,0,0,0,1,1,1,0,0,0,0,0,0,0,0,0,0,0,0,0,0,0,0,0,0,0,1,1,1,0,0,0,0,0,0,0,0,0,0,0,0,0,0,0,0,0,0,0,1,8,8,0,0,9,9,9,9,9,9,9,9,9,9,9,9,9,9,0,0,0,8,8,8,0,0,0,0,0,0,0,0,0,0,0,0,0,0,0,0,0,0,9,9,0,0,0,0,0,0,2
2,0,0,0,1,1,1,0,0,0,0,0,0,0,0,0,0,0,0,0,0,0,0,0,0,0,1,1,1,0,0,0,0,0,0,0,0,0,0,0,0,0,0,0,0,0,0,0,1,8,8,0,0,0,0,0,0,0,0,0,0,0,0,0,0,0,0,0,0,0,1,1,1,9,9,9,0,0,9,9,9,0,0,9,9,9,0,0,0,0,0,9,9,0,0,0,0,0,0,2
2,0,0,0,1,1,1,0,0,0,0,0,0,0,0,0,0,0,0,0,0,0,0,0,0,0,1,1,1,0,0,0,0,0,0,0,0,0,0,0,0,0,0,0,0,0,0,0,1,1,1,0,0,0,0,0,0,0,0,0,0,0,0,0,0,0,0,0,0,0,1,1,1,0,0,0,0,0,0,0,0,0,0,0,0,0,0,0,0,0,0,9,9,0,0,0,0,0,0,2
2,0,0,0,1,1,1,0,0,0,0,0,0,0,0,0,0,0,0,0,0,0,0,0,0,0,1,1,1,0,0,10,10,10,0,0,0,0,0,0,0,0,10,10,0,0,0,0,1,1,1,0,0,0,0,0,0,0,0,0,0,0,0,0,0,0,0,0,0,0,1,1,1,0,0,0,0,0,0,0,0,0,0,0,0,0,0,0,0,0,0,9,9,0,0,0,0,0,0,2
2,0,0,0,1,1,1,0,0,1,1,1,0,0,0,0,0,0,0,1,1,1,1,0,0,0,1,1,1,0,0,1,1,1,0,0,0,0,0,0,0,1,1,1,1,0,0,0,1,1,1,0,0,1,1,1,0,0,0,0,0,0,0,1,1,1,1,0,0,0,1,1,1,0,0,8,8,8,0,0,0,0,0,0,0,1,1,1,1,0,0,9,9,0,0,0,0,0,0,2
2,0,0,0,1,1,1,0,0,0,0,0,0,0,0,0,0,0,0,4,1,1,1,0,0,0,1,1,1,0,0,0,0,0,0,0,0,0,0,0,0,4,8,8,1,0,0,0,1,8,8,0,0,0,0,0,0,0,0,0,0,0,0,4,1,1,1,0,0,0,1,1,1,0,0,0,0,0,0,0,0,0,0,0,0,4,1,1,1,0,0,0,0,0,0,0,0,0,0,2
2,0,0,0,1,1,1,0,0,0,0,0,0,0,0,0,0,0,0,4,1,1,1,0,0,0,1,1,1,0,0,0,0,0,0,0,0,0,0,0,0,4,8,8,1,0,0,0,1,8,8,0,0,0,0,0,0,0,0,0,0,0,0,4,1,1,1,0,0,0,1,1,1,0,0,0,0,0,0,0,0,0,0,0,0,4,1,1,1,0,0,0,0,0,0,0,0,0,0,2
2,0,0,0,1,1,1,0,0,0,0,0,0,0,1,1,1,0,0,4,1,1,1,0,0,0,1,1,1,0,0,0,0,0,0,0,1,1,1,0,0,4,8,8,1,0,0,0,1,1,1,0,0,0,0,0,0,0,8,8,8,0,0,4,1,1,1,0,0,0,1,1,1,0,0,0,0,0,0,0,8,8,8,0,0,4,1,1,1,0,0,0,0,0,0,0,0,0,0,2
2,0,0,0,1,1,1,0,0,0,0,0,0,0,0,0,0,0,0,4,1,1,1,0,0,0,1,1,1,0,0,0,0,0,0,0,0,0,0,0,0,4,8,8,1,0,0,0,1,1,1,0,0,0,0,0,0,0,0,0,0,0,0,4,1,1,1,0,0,0,1,1,1,0,0,0,0,0,0,0,0,0,0,0,0,4,1,1,1,0,0,0,0,0,0,0,0,0,0,2
2,0,0,0,1,1,1,0,0,0,0,0,0,0,0,0,0,0,0,4,1,1,1,0,0,0,1,1,1,0,0,0,0,0,0,0,0,0,0,0,0,4,8,8,1,0,0,0,1,1,1,0,0,0,0,0,0,0,0,0,0,0,0,4,1,1,1,0,0,0,1,1,1,0,0,0,0,0,0,0,0,0,0,0,0,4,1,1,1,0,0,0,0,0,0,0,0,0,0,2
2,0,0,0,1,1,1,0,0,1,1,1,0,0,0,0,0,0,0,4,1,1,1,0,0,0,1,1,1,0,0,1,1,1,0,0,0,0,0,0,0,4,8,8,1,0,0,0,1,1,1,0,0,1,1,1,0,0,0,0,0,0,0,4,1,1,1,0,0,0,1,1,1,0,0,8,8,8,0,0,0,0,0,0,0,4,1,1,1,0,0,0,0,0,0,0,0,0,0,2
2,0,0,0,0,0,0,0,0,0,0,0,0,0,0,0,0,0,0,4,1,1,1,0,0,0,0,0,0,0,0,0,0,0,0,0,0,0,0,0,0,4,8,8,1,0,0,0,0,0,0,0,0,0,0,0,0,0,0,0,0,0,0,4,1,1,1,0,0,0,0,0,0,0,0,0,0,0,0,0,0,0,0,0,0,4,1,1,1,0,0,0,0,0,0,0,0,0,0,2
2,0,7,0,0,0,0,0,0,0,0,0,0,0,0,0,0,0,0,4,1,1,1,0,0,0,0,0,0,0,0,0,0,0,0,0,0,0,0,0,0,4,8,8,1,0,0,0,0,0,0,0,0,0,0,0,0,0,0,0,0,0,0,4,1,1,1,0,0,0,0,0,0,0,0,0,0,0,0,0,0,0,0,0,0,4,1,1,1,0,0,0,0,0,0,0,0,7,0,2
2,1,1,1,1,1,1,0,0,0,0,0,0,0,0,0,0,0,0,4,1,1,1,1,1,1,1,1,1,0,0,0,0,0,0,0,0,0,0,0,0,4,8,8,1,1,1,1,1,1,1,0,0,0,0,0,0,0,0,0,0,0,0,4,1,1,1,1,1,1,1,1,1,0,0,0,0,0,0,0,0,0,0,0,0,4,1,1,1,8,8,8,8,1,1,1,1,1,1,2
2,3,3,3,3,3,3,3,3,3,3,3,3,3,3,3,3,3,3,3,3,3,3,3,3,3,3,3,3,3,3,3,3,3,3,3,3,3,3,3,3,3,3,3,3,3,3,3,3,3,3,3,3,3,3,3,3,3,3,3,3,3,3,3,3,3,3,3,3,3,3,3,3,3,3,3,3,3,3,3,3,3,3,3,3,3,3,3,3,3,3,3,3,3,3,3,3,3,3,2

